1111111
1E10001
1010P01
100C001
1111111
