111111
1000e1
1EC001
1000P1
111111
